9 24
////////////////////////
/----------------------/
/-------------------2--/
/-------------------2--/
/-//-///////////////////
/--------------------10/
/--------------------1-/
/----------------------/
////////////////////////